1 1
6 6
######
#   ##
# #  #
# #E #
#    #
######