1 4
6 6
######
#    #
# E  #
#    #
#    #
######