2 10
12 16
################
#    ##        #
#   ##  # ### ##
#         ###  #
#   #####      #
#   ##E ##   ###
#       ##  ## #
#   #####   #  #
#  ##    ##    #
#  ##  #  ###  #
#     ###      #
################