1 3
6 6
######
#   E#
#    #
#    #
#    #
######